######################
#. ...!      |       2
#.....#      #       #
#..@..####    #     ##
#....... #     #   ###
#              #  ####
######################