######################
#.....!              2
#.....#              #
#..@..#              #
######################
