######################
#. ...               #
#.....#      #       #
#..@..####    #     ##
#....... #     #   ###
#              #  ####
######################