######################
#. ...               #
#.....#      #       #
#..@..####    #     ##
#....... #     #   ###
#              #  ####
############ #########
#            !       #
#            #       #
#            #########
#            #       #
#            ###!#####
#                    #
######################